100% leið	100%-leið
10. bekkinga	10.-bekkinga
110% leið	110%-leið
A4 blaði	A4-blaði
A deild	A-deild
ADHD greining	ADHD-greining
ADHD lyf	ADHD-lyf
ADHD röskun	ADHD-röskun
ADHD samtaka	ADHD-samtaka
ADHD samtök	ADHD-samtök
ADHD teymi	ADHD-teymi
A flokk	A-flokk
AGS áætlun	AGS-áætlun
AGS lán	AGS-lán
AGS plan	AGS-plan
A hluta	A-hluta
A hluti	A-hluti
Airbnb gisting	Airbnb-gisting
Airbnb íbúðir	Airbnb-íbúðir
Airbnb starfsemi	Airbnb-starfsemi
a lið	a-lið
A lista	A-lista
A listi	A-listi
alzheimer sjúkling	alzheimer-sjúkling
ART verkefni	ART-verkefni
ART þjálfun	ART-þjálfun
ART þjónust	ART-þjónust
ASÍ félag	ASÍ-félag
ASÍ töxtum	ASÍ-töxtum
ASÍ þing	ASÍ-þing
A svæði	A-svæði
ÁTVR búð	ÁTVR-búð
ÁTVR leið	ÁTVR-leið
auka Alþingi	auka-Alþingi
Austara Eylendi	Austara-Eylendi
Austari Jökulsá	Austari-Jökulsá
Austur Afríku	Austur-Afríku
Austur Asíu	Austur-Asíu
Austur Barðastrandarsýslu	Austur-Barðastrandarsýslu
Austur Evrópa	Austur-Evrópa
austur evrópsk	austur-evrópsk
Austur Evrópu	Austur-Evrópu
Austur Flóa	Austur-Flóa
Austur Ghouta	Austur-Ghouta
Austur Grænland	Austur-Grænland
Austur Húnavatnssýslu	Austur-Húnavatnssýslu
Austur Húnvetning	Austur-Húnvetning
Austur Íslandsstraum	Austur-Íslandsstraum
Austur Jerúsalem	Austur-Jerúsalem
Austur Skaftafellssýslu	Austur-Skaftafellssýslu
Austur Skaftfellinga	Austur-Skaftfellinga
Austur Tímor	Austur-Tímor
Austur Úkraínu	Austur-Úkraínu
Austur Þjóðverjar	Austur-Þjóðverjar
austur þýsk	austur-þýsk
Austur Þýskaland	Austur-Þýskaland
Avens samkomulag	Avens-samkomulag
Avens viðskipt	Avens-viðskipt
AVS sjóð	AVS-sjóð
B1 leið	B1-leið
BA gráðu	BA-gráðu
Balí fund	Balí-fund
BA nám	BA-nám
BA próf	BA-próf
BA ritgerð	BA-ritgerð
Basel nefnd	Basel-nefnd
Basel reglur	Basel-reglur
B deild	B-deild
B.Ed. gráðu	B.Ed.-gráðu
Benelux lönd	Benelux-lönd
BEPS áætlun	BEPS-áætlun
B flokk	B-flokk
b hlut	b-hlut
B hlut	B-hlut
BHM félaga	BHM-félaga
BHM félögum	BHM-félögum
B leið	B-leið
b lið	b-lið
B lið	B-lið
Bloomberg frétta	Bloomberg-frétta
Bologna ferli	Bologna-ferli
Bosnía Hersegóvína	Bosnía-Hersegóvína
Bosníu Hersegóvínu	Bosníu-Hersegóvínu
Brexit ferli	Brexit-ferli
Brexit kosning	Brexit-kosning
Brussel sáttmál	Brussel-sáttmál
Brussel valdi	Brussel-valdi
Brussel viðmið	Brussel-viðmið
BS gráðu	BS-gráðu
BS nám	BS-nám
BS próf	BS-próf
BSRB félaga	BSRB-félaga
B svæði	B-svæði
Bush stjórn	Bush-stjórn
CAD hlutfall	CAD-hlutfall
Cayman eyjum	Cayman-eyjum
C deild	C-deild
CE merk	CE-merk
CERT Í	CERT-Í
CE samræmismerk	CE-samræmismerk
CFC löggjöf	CFC-löggjöf
CFC reglna	CFC-reglna
CFC reglu	CFC-reglu
C flokk	C-flokk
Chicago samning	Chicago-samning
Chicago sáttmál	Chicago-sáttmál
C hluta	C-hluta
C hluti	C-hluti
CIRR vexti	CIRR-vexti
CITES samning	CITES-samning
c lið	c-lið
C lið	C-lið
Columbia háskól	Columbia-háskól
DAC nefnd	DAC-nefnd
DAC ríkja	DAC-ríkja
DAC skýrsl	DAC-skýrsl
déjà vu	déjà-vu
D hluta	D-hluta
d'Hondt regl	d'Hondt-regl
d lið	d-lið
D lið	D-lið
DNA rannsókn	DNA-rannsókn
Doha lotu	Doha-lotu
Doha samningalotu	Doha-samningalotu
Doha viðræð	Doha-viðræð
dómínó áhrif	dómínó-áhrif
Downing stræti	Downing-stræti
Downs heilkenni	Downs-heilkenni
DRG greining	DRG-greining
DRG kerfi	DRG-kerfi
D svæði	D-svæði
Dyflinnar reglugerð	Dyflinnar-reglugerð
Dyflinnar samningnum	Dyflinnar-samningnum
EB gerð	EB-gerð
ECA verkefni	ECA-verkefni
ECOFIN fundi	ECOFIN-fundi
ECTS eining	ECTS-eining
E deild	E-deild
Edge reikning	Edge-reikning
EES aðild	EES-aðild
EES ákvæði	EES-ákvæði
EES borgara	EES-borgara
EES borgurum	EES-borgurum
EES dvalarleyfi	EES-dvalarleyfi
EES gagnagrunn	EES-gagnagrunn
EES gerð	EES-gerð
EES innleiðing	EES-innleiðing
EES kafla	EES-kafla
EES land	EES-land
EES löggjafar	EES-löggjafar
EES löggjöf	EES-löggjöf
EES lönd	EES-lönd
EES mál	EES-mál
EES nefnd	EES-nefnd
EES reglna	EES-reglna
EES reglu	EES-reglu
EES rétt	EES-rétt
EES ríki	EES-ríki
EES ríkj	EES-ríkj
EES samkomulag	EES-samkomulag
EES samning	EES-samning
EES samstarf	EES-samstarf
EES stofnan	EES-stofnan
EES svæði	EES-svæði
EES tilskip	EES-tilskip
EES vettvang	EES-vettvang
EES viðbæt	EES-viðbæt
EES þjóð	EES-þjóð
Efra Breiðholt	Efra-Breiðholt
Efra Sog	Efra-Sog
EFTA dóm	EFTA-dóm
EFTA fundi	EFTA-fundi
EFTA krækj	EFTA-krækj
EFTA landa	EFTA-landa
EFTA lönd	EFTA-lönd
EFTA megin	EFTA-megin
EFTA nefnd	EFTA-nefnd
EFTA ríki	EFTA-ríki
EFTA ríkj	EFTA-ríkj
EFTA samning	EFTA-samning
EFTA samstarf	EFTA-samstarf
EFTA sáttmál	EFTA-sáttmál
EFTA skrifstof	EFTA-skrifstof
EFTA stoð	EFTA-stoð
EFTA stofnan	EFTA-stofnan
EFTA þingm	EFTA-þingm
EFTA þjóð	EFTA-þjóð
E hluta	E-hluta
ekki svar	ekki-svar
Ekron starfsþjálfun	Ekron-starfsþjálfun
e lið	e-lið
EPS kerf	EPS-kerf
ESA dómstól	ESA-dómstól
ESA gögn	ESA-gögn
ESA mál	ESA-mál
ESA reglu	ESA-reglu
ESA skjöl	ESA-skjöl
ESB aðild	ESB-aðild
ESB aðlögun	ESB-aðlögun
ESB andstæðing	ESB-andstæðing
ESB borgara	ESB-borgara
ESB ferli	ESB-ferli
ESB flokkur	ESB-flokkur
ESB gerð	ESB-gerð
ESB landa	ESB-landa
ESB löggjafar	ESB-löggjafar
ESB löggjöf	ESB-löggjöf
ESB lönd	ESB-lönd
ESB mál	ESB-mál
ESB reglu	ESB-reglu
ESB rétt	ESB-rétt
ESB ríki	ESB-ríki
ESB ríkj	ESB-ríkj
ESB samning	ESB-samning
ESB samstarf	ESB-samstarf
ESB sinna	ESB-sinna
ESB sinni	ESB-sinni
ESB svæði	ESB-svæði
ESB tillöguna	ESB-tillöguna
ESB tilskip	ESB-tilskip
ESB umræð	ESB-umræð
ESB umsókn	ESB-umsókn
ESB verktak	ESB-verktak
ESB verktökum	ESB-verktökum
ESB viðræð	ESB-viðræð
ESB þing	ESB-þing
ESB þjóð	ESB-þjóð
ETS kerfi	ETS-kerfi
Eurovision keppni	Eurovision-keppni
excel skjal	excel-skjal
excel skjöl	excel-skjöl
Facebook færslu	Facebook-færslu
Facebook síða	Facebook-síða
Facebook síðu	Facebook-síðu
Farice sæstreng	Farice-sæstreng
Farice samning	Farice-samning
Farice streng	Farice-streng
FIH bank	FIH-bank
f lið	f-lið
G20 ríkj	G20-ríkj
G7 ríkj	G7-ríkj
G8 ríkj	G8-ríkj
Gallup kannanir	Gallup-kannanir
Gallup könnun	Gallup-könnun
GATS samning	GATS-samning
GATS viðræðu	GATS-viðræðu
GATT samkomulag	GATT-samkomulag
GATT samning	GATT-samning
Gaza strönd	Gaza-strönd
Gaza svæði	Gaza-svæði
GDPR reglugerð	GDPR-reglugerð
Gini stuðli	Gini-stuðli
Gini stuðul	Gini-stuðul
Glass Steagall	Glass-Steagall
g lið	g-lið
GPS hnit	GPS-hnit
GPS kerfi	GPS-kerfi
GPS mæla	GPS-mæla
GPS staðsetningar	GPS-staðsetningar
GPS tæki	GPS-tæki
GPS tækjum	GPS-tækjum
GPS tækni	GPS-tækni
G regla	G-regla
G reglu	G-reglu
GSM farsíma	GSM-farsíma
GSM kerfi	GSM-kerfi
GSM samband	GSM-samband
GSM síma	GSM-síma
GSM sími	GSM-sími
GSM símum	GSM-símum
GSM þjónust	GSM-þjónust
Guantanamo búð	Guantanamo-búð
Guantanamo fangabúð	Guantanamo-fangabúð
Guantanamo flóa	Guantanamo-flóa
Haag samning	Haag-samning
Hafró afla	Hafró-afla
Hafró afli	Hafró-afli
Halls ákvæði	Halls-ákvæði
Halls fyrirvar	Halls-fyrirvar
Hamas hreyfing	Hamas-hreyfing
Hamas liða	Hamas-liða
Hamas samtök	Hamas-samtök
Harvard háskóla	Harvard-háskóla
Harvard háskóli	Harvard-háskóli
HeForShe átakið	HeForShe-átakið
Helsinki sáttmál	Helsinki-sáttmál
Helsinki yfirlýsing	Helsinki-yfirlýsing
HFF bréf	HFF-bréf
h lið	h-lið
HOFF verkefni	HOFF-verkefni
hókus pókus	hókus-pókus
Hoyvíkur samning	Hoyvíkur-samning
HPV bóluefni	HPV-bóluefni
HPV bólusetning	HPV-bólusetning
HPV smiti	HPV-smiti
HPV sýkingu	HPV-sýkingu
HPV veira	HPV-veira
HPV veiru	HPV-veiru
HPV veirunni	HPV-veirunni
Hvíta Rússland	Hvíta-Rússland
Icesave ábyrgð	Icesave-ábyrgð
Icesave deila	Icesave-deila
Icesave deilu	Icesave-deilu
Icesave frumvarp	Icesave-frumvarp
Icesave hneyksli	Icesave-hneyksli
Icesave innlán	Icesave-innlán
Icesave innstæð	Icesave-innstæð
Icesave klúðri	Icesave-klúðri
Icesave kosning	Icesave-kosning
Icesave kröfu	Icesave-kröfu
Icesave lán	Icesave-lán
Icesave lög	Icesave-lög
Icesave mál	Icesave-mál
Icesave reikning	Icesave-reikning
Icesave samkomulag	Icesave-samkomulag
Icesave samning	Icesave-samning
Icesave skuld	Icesave-skuld
Icesave umræð	Icesave-umræð
Icesave viðræð	Icesave-viðræð
IFS greining	IFS-greining
I leið	I-leið
i lið	i-lið
ILO samþykkt	ILO-samþykkt
ÍLS veðbréf	ÍLS-veðbréf
IMMI stofnun	IMMI-stofnun
Indefence hóp	Indefence-hóp
Indefence menn	Indefence-menn
Indefence samt	Indefence-samt
INSPIRE tilskipunin	INSPIRE-tilskipunin
intersex barn	intersex-barn
intersex börn	intersex-börn
intersex breytileika	intersex-breytileika
intersex einstakling	intersex-einstakling
intersex fólk	intersex-fólk
IPA aðlögunarstyrki	IPA-aðlögunarstyrki
IPA aðstoð	IPA-aðstoð
IPA kerfi	IPA-kerfi
IPA mál	IPA-mál
IPA rammareglugerð	IPA-rammareglugerð
IPA styrk	IPA-styrk
IPA verkefna	IPA-verkefna
IPA verkefni	IPA-verkefni
IP tala	IP-tala
IP tölu	IP-tölu
ISIS samtak	ISIS-samtak
ISIS samtök	ISIS-samtök
íslensk mónakóska	íslensk-mónakóska
Istanbúl samning	Istanbúl-samning
já hnappinn	já-hnappinn
já hreyfing	já-hreyfing
já i	já-i
j lið	j-lið
KB banka	KB-banka
KB banki	KB-banki
Ki moon	Ki-moon
k lið	k-lið
krónu skerðing	krónu-skerðing
Kyoto bókun	Kyoto-bókun
Kyoto rík	Kyoto-rík
Kyoto samkomulag	Kyoto-samkomulag
Kyoto samning	Kyoto-samning
Kyoto samþykkt	Kyoto-samþykkt
Kyoto sáttmál	Kyoto-sáttmál
Kyoto tímabil	Kyoto-tímabil
Laffer kúrf	Laffer-kúrf
LDC rík	LDC-rík
LGBT fólk	LGBT-fólk
LÍN frumvarp	LÍN-frumvarp
LÍN mál	LÍN-mál
Lissabon áætlun	Lissabon-áætlun
Lissabon ferli	Lissabon-ferli
Lissabon samning	Lissabon-samning
Lissabon sáttmál	Lissabon-sáttmál
Litla Hraun	Litla-Hraun
l lið	l-lið
Lófóten svæði	Lófóten-svæði
Maastricht samkomulag	Maastricht-samkomulag
Maastricht sáttmál	Maastricht-sáttmál
Maastricht skilyrð	Maastricht-skilyrð
Magma mál	Magma-mál
MA gráð	MA-gráð
MA ritgerð	MA-ritgerð
MARPOL samning	MARPOL-samning
Marshall aðstoð	Marshall-aðstoð
Mayen svæði	Mayen-svæði
MBA nám	MBA-nám
McCarthy tímabili	McCarthy-tímabili
McKinsey skýrsl	McKinsey-skýrsl
metoo bylting	metoo-bylting
MFS eining	MFS-eining
Mið Afríkulýðveldi	Mið-Afríkulýðveldi
Mið Ameríku	Mið-Ameríku
Mið Asíu	Mið-Asíu
Mið Austurlöndum	Mið-Austurlöndum
Mið Evrópu	Mið-Evrópu
MiFID tilskipun	MiFID-tilskipun
m lið	m-lið
MND félag	MND-félag
MND sjúk	MND-sjúk
MP banka	MP-banka
MP banki	MP-banki
MSC merk	MSC-merk
MSC vottun	MSC-vottun
MS félag	MS-félag
MS sjúkdóm	MS-sjúkdóm
MS sjúkling	MS-sjúkling
Nagorno Karabakh	Nagorno-Karabakh
NATO aðild	NATO-aðild
NATO fund	NATO-fund
NATO her	NATO-her
NATO lönd	NATO-lönd
NATO ráðs	NATO-ráðs
NATO ríki	NATO-ríki
NATO ríkj	NATO-ríkj
NATO samning	NATO-samning
NATO samstarf	NATO-samstarf
NATO væðing	NATO-væðing
NATO verkefn	NATO-verkefn
NATO þing	NATO-þing
NATO þjóð	NATO-þjóð
Neðri Þjórsá	Neðri-Þjórsá
nei hnappinn	nei-hnappinn
nei hreyfing	nei-hreyfing
nei i	nei-i
nei takkan	nei-takkan
n lið	n-lið
NMT kerfi	NMT-kerfi
Norðaustur Atlantshaf	Norðaustur-Atlantshaf
Norðaustur Grænlandi	Norðaustur-Grænlandi
Norðaustur Rússlandi	Norðaustur-Rússlandi
Norður Afríku	Norður-Afríku
Norður Amerík	Norður-Amerík
Norður Atlantshaf	Norður-Atlantshaf
Norður Evróp	Norður-Evróp
Norður Írland	Norður-Írland
Norður Íshaf	Norður-Íshaf
Norður Kórea	Norður-Kórea
Norður Kóreu	Norður-Kóreu
Norður Noreg	Norður-Noreg
Norður Þingeyjarsýsl	Norður-Þingeyjarsýsl
Norðvestur Atlantshaf	Norðvestur-Atlantshaf
Norðvestur Evrópu	Norðvestur-Evrópu
Norðvestur Rússland	Norðvestur-Rússland
norsk íslenska	norsk-íslenska
norsk íslenski	norsk-íslenski
norsk íslenskr	norsk-íslenskr
norsk íslensku	norsk-íslensku
NPA miðstöð	NPA-miðstöð
NPA samning	NPA-samning
NPA verkefni	NPA-verkefni
NPA þjónust	NPA-þjónust
NPT samning	NPT-samning
Nýja Ísland	Nýja-Ísland
Nýja Sjáland	Nýja-Sjáland
Nýju Delí	Nýju-Delí
OECD land	OECD-land
OECD lönd	OECD-lönd
OECD meðaltal	OECD-meðaltal
OECD ríki	OECD-ríki
OECD ríkj	OECD-ríkj
OECD skýrsl	OECD-skýrsl
OECD þjóð	OECD-þjóð
Olweusar áætlun	Olweusar-áætlun
OPCAT bókun	OPCAT-bókun
OPCAT eftirlit	OPCAT-eftirlit
OPEC ríkin	OPEC-ríkin
ÖSE stofnun	ÖSE-stofnun
ÖSE þing	ÖSE-þing
OSPAR samning	OSPAR-samning
Oxford háskóla	Oxford-háskóla
Palermó bókun	Palermó-bókun
Palermó samning	Palermó-samning
Páls lög	Páls-lög
Panama hneyksli	Panama-hneyksli
Panama leka	Panama-leka
Panama lekinn	Panama-lekinn
Panama skjala	Panama-skjala
Panama skjöl	Panama-skjöl
PET skanna	PET-skanna
PIP púða	PIP-púða
PISA kannan	PISA-kannan
PISA könnun	PISA-könnun
PISA próf	PISA-próf
PISA rannsókn	PISA-rannsókn
Prag samþykkt	Prag-samþykkt
RAI kerfi	RAI-kerfi
RAI mat	RAI-mat
Ramsar samning	Ramsar-samning
REACH reglugerð	REACH-reglugerð
RED tilskipun	RED-tilskipun
REI mál	REI-mál
RES orkuskóla	RES-orkuskóla
Reuters frétta	Reuters-frétta
Ríó ráðstefnu	Ríó-ráðstefnu
Ríó sáttmál	Ríó-sáttmál
Ríó yfirlýsing	Ríó-yfirlýsing
R lista	R-lista
R listi	R-listi
RÚV frumvarp	RÚV-frumvarp
RÚV mál	RÚV-mál
Sádi Araba	Sádi-Araba
Sádi Arabía	Sádi-Arabía
Sádi Arabíu	Sádi-Arabíu
SALEK samkomulag	SALEK-samkomulag
Schengen gerð	Schengen-gerð
Schengen land	Schengen-land
Schengen lönd	Schengen-lönd
Schengen ríki	Schengen-ríki
Schengen ríkj	Schengen-ríkj
Schengen samkomulag	Schengen-samkomulag
Schengen samning	Schengen-samning
Schengen samstarf	Schengen-samstarf
Schengen svæði	Schengen-svæði
Schengen upplýsingakerfi	Schengen-upplýsingakerfi
Schengen vegabréf	Schengen-vegabréf
Seychelles eyjum	Seychelles-eyjum
Singapúr samning	Singapúr-samning
SIS mat	SIS-mat
S lyf	S-lyf
S merk	S-merk
SMS sending	SMS-sending
SMS skeyti	SMS-skeyti
SMS skilaboð	SMS-skilaboð
SOFA samning	SOFA-samning
STEF gjald	STEF-gjald
STEF gjöld	STEF-gjöld
Stoltenberg skýrsl	Stoltenberg-skýrsl
Stóra Bretland	Stóra-Bretland
stór höfuðborgarsvæðinu	stór-höfuðborgarsvæðinu
Stór Reykjavík	Stór-Reykjavík
Straums Burðaráss	Straums-Burðaráss
Straumur Burðarás	Straumur-Burðarás
Strauss Kahn	Strauss-Kahn
Suðaustur Asía	Suðaustur-Asía
Suðaustur Asíu	Suðaustur-Asíu
Suður Afríka	Suður-Afríka
Suður Afríku	Suður-Afríku
Suður Ameríka	Suður-Ameríka
Suður Ameríku	Suður-Ameríku
Suður Asíu	Suður-Asíu
Suður Evrópu	Suður-Evrópu
Suður Kórea	Suður-Kórea
Suður Kóreu	Suður-Kóreu
Suður Súdan	Suður-Súdan
Suður Þingeying	Suður-Þingeying
Suður Þingeyjarsýsl	Suður-Þingeyjarsýsl
TAIEX styrki	TAIEX-styrki
Tetra kerfi	Tetra-kerfi
TF Eir	TF-Eir
TF LÍ	TF-LÍ
TF Líf	TF-Líf
TF SI	TF-SI
TF Sif	TF-Sif
T gatnamót	T-gatnamót
THC magn	THC-magn
TiSA samning	TiSA-samning
TiSA viðræð	TiSA-viðræð
Tobin skatt	Tobin-skatt
TRIPS samning	TRIPS-samning
Trump stjórn	Trump-stjórn
TSM reglugerð	TSM-reglugerð
TTIP samning	TTIP-samning
TTIP viðræð	TTIP-viðræð
U beygja	U-beygja
U beygju	U-beygju
UNICEF skýrsl	UNICEF-skýrsl
Vestari Jökulsá	Vestari-Jökulsá
Vestia mál	Vestia-mál
Vestur Afríku	Vestur-Afríku
Vestur Barðastrandarsýsl	Vestur-Barðastrandarsýsl
Vestur Evrópa	Vestur-Evrópa
Vestur Evrópu	Vestur-Evrópu
Vestur Húnavatnssýsl	Vestur-Húnavatnssýsl
Vestur Íslending	Vestur-Íslending
Vestur Norðurl	Vestur-Norðurl
Vestur Noreg	Vestur-Noreg
Vestur Sahara	Vestur-Sahara
Vestur Skaftafellssýsl	Vestur-Skaftafellssýsl
Vestur Þýskaland	Vestur-Þýskaland
VES þing	VES-þing
VG frumvarpi	VG-frumvarpi
Víetnam stríð	Víetnam-stríð
VIRK Starfsendurhæfing	VIRK-Starfsendurhæfing
VRA vottun	VRA-vottun
VS afla	VS-afla
VS afli	VS-afli
Washington ríki	Washington-ríki
Wintris mál	Wintris-mál
WTO samning	WTO-samning
Yale háskóla	Yale-háskóla
