ægir	Ægir
ægi	Ægi
ægis	Ægis
ágúst	Ágúst
ágústi	Ágústi
ágústar	Ágústar
ágústs	Ágústs
áki	Áki
áka	Áka
alda	Alda
öldu	Öldu
alfa	Alfa
ölfu	Ölfu
arna	Arna
árna	Árna
ás	Ás
áss	Áss
askur	Askur
ask	Ask
aski	Aski
asks	Asks
ástríður	Ástríður
auðar	Auðar
auði	Auði
auður	Auður
bára	Bára
báru	Báru
barkar	Barkar
berg	Berg
bergi	Bergi
bergs	Bergs
berki	Berki
birgir	Birgir
birgi	Birgi
birgis	Birgis
birkir	Birkir
birki	Birki
birkis	Birkis
birnir	Birnir
birta	Birta
birtu	Birtu
bjartur	Bjartur
bjart	Bjart
bjarti	Bjarti
bjarts	Bjarts
björg	Björg
björgu	Björgu
bjargar	Bjargar
björk	Björk
bjarkar	Bjarkar
birni	Birni
bjarnar	Bjarnar
björn	Björn
björns	Björns
björt	Björt
björtu	Björtu
bjartar	Bjartar
blær	Blær
blæ	Blæ
blæs	Blæs
blævi	Blævi
blævar	Blævar
blævari	Blævari
blævars	Blævars
boga	Boga
bogi	Bogi
bolli	Bolli
bolla	Bolla
brá	Brá
brár	Brár
breki	Breki
breka	Breka
broddi	Broddi
brodda	Brodda
brynja	Brynja
brynju	Brynju
burkni	Burkni
burkna	Burkna
bylgja	Bylgja
bylgju	Bylgju
börkur	Börkur
dagur	Dagur
dag	Dag
degi	Degi
dags	Dags
dögg	Dögg
daggar	Daggar
darri	Darri
darra	Darra
dís	Dís
dísar	Dísar
dofri	Dofri
dofra	Dofra
drífa	Drífa
drífu	Drífu
drafnar	Drafnar
dröfn	Dröfn
eiður	Eiður
eið	Eið
eiði	Eiði
eiðs	Eiðs
eik	Eik
eikar	Eikar
einar	Einar
einari	Einari
einars	Einars
einir	Einir
eini	Eini
einis	Einis
eir	Eir
eiri	Eiri
eirar	Eirar
eirs	Eirs
eldar	Eldar
eldari	Eldari
eldars	Eldars
erlendur	Erlendur
erlend	Erlend
erlendi	Erlendi
erlends	Erlends
erlendar	Erlendar
örn	Örn
erni	Erni
arnar	Arnar
ernir	Ernir
erni	Erni
ernis	Ernis
erna	Erna
ernu	Ernu
eskil	Eskil
eyja	Eyja
eyju	Eyju
finnur	Finnur
finn	Finn
finni	Finni
finns	Finns
fífa	Fífa
fífu	Fífu
fjóla	Fjóla
fjólu	Fjólu
freyja	Freyja
freyju	Freyju
fríða	Fríða
fríðu	Fríðu
frosta	Frosta
frosti	Frosti
fróði	Fróði
fróða	Fróða
fúsi	Fúsi
fúsa	Fúsa
garðar	Garðar
garðari	Garðari
garðars	Garðars
gauk	Gauk
gauki	Gauki
gauks	Gauks
gaukur	Gaukur
gauta	Gauta
gerði	Gerði
gerður	Gerður
gerðar	Gerðar
gest	Gest
gesti	Gesti
gests	Gests
gestur	Gestur
gils	Gils
grettir	Grettir
gretti	Gretti
grettis	Grettis
grímur	Grímur
gróa	Gróa
gróu	Gróu
gutti	Gutti
gutta	Gutta
gyrðir	Gyrðir
gyrði	Gyrði
gyrðis	Gyrðis
halla	Halla
höllu	Höllu
hallur	Hallur
hall	Hall
halli	Halli
halls	Halls
harpa	Harpa
hörpu	Hörpu
haukur	Haukur
hauk	Hauk
hauki	Hauki
hauks	Hauks
heiða	Heiða
heiðu	Heiðu
heiðar	Heiðar
heiðari	Heiðari
heiðars	Heiðars
heiður	Heiður
heiði	Heiði
heimir	Heimir
heimi	Heimi
heimis	Heimis
hekla	Hekla
helga	Helga
helgu	Helgu
helgi	Helgi
hermann	Hermann
hermanni	Hermanni
hermanns	Hermanns
hersi	Hersi
hersir	Hersir
hersis	Hersis
hjálmar	Hjálmar
hjálmari	Hjálmari
hjálmars	Hjálmars
hlín	Hlín
hlínar	Hlínar
hlyni	Hlyni
hlyns	Hlyns
hlynur	Hlynur
hnefill	Hnefill
hnefil	Hnefil
hnefli	Hnefli
hnefils	Hnefils
hrafn	Hrafn
hrafni	Hrafni
hrafns	Hrafns
hrafntinna	Hrafntinna
hrafntinnu	Hrafntinnu
hrefna	Hrefna
hrefnu	Hrefnu
hrein	Hrein
hreini	Hreini
hreinn	Hreinn
hreins	Hreins
hringur	Hringur
hring	Hring
hringi	Hringi
hrings	Hrings
hrönn	Hrönn
hrannar	Hrannar
hugi	Hugi
huga	Huga
huld	Huld
huldar	Huldar
hulda	Hulda
huldu	Huldu
hörður	Hörður
hörð	Hörð
herði	Herði
harðar	Harðar
jökull	Jökull
jökul	Jökul
jökli	Jökli
jökuls	Jökuls
karl	Karl
karli	Karli
karls	Karls
katla	Katla
ketill	Ketill
ketil	Ketil
katli	Katli
ketils	Ketils
kristinn	Kristinn
kristin	Kristin
kristni	Kristni
kristins	Kristins
leifi	Leifi
leifs	Leifs
lind	Lind
lindar	Lindar
líf	Líf
lína	Lína
línu	Línu
lóa	Lóa
lóu	Lóu
loft	Loft
lofti	Lofti
logi	Logi
loga	Loga
loki	Loki
loka	Loka
lýður	Lýður
lýð	Lýð
lýði	Lýði
lýðs	Lýðs
má	Má
máni	Máni
mána	Mána
mar	Mar
mars	Mars
mörður	Mörður
mörð	Mörð
merði	Merði
marðar	Marðar
mjöll	Mjöll
mjallar	Mjallar
nótt	Nótt
nóttar	Nóttar
nætur	Nætur
oddur	Oddur
odd	Odd
oddi	Oddi
odds	Odds
ófeigur	Ófeigur
ófeig	Ófeig
ófeigi	Ófeigi
ófeigs	Ófeigs
óðinn	Óðinn
ögn	Ögn
agnar	Agnar
örn	Örn
ormur	Ormur
orm	Orm
ormi	Ormi
orms	Orms
ósk	Ósk
óskar	Óskar
ösp	Ösp
pálmi	Pálmi
pálma	Pálma
pálmar	Pálmar
perla	Perla
perlu	Perlu
rán	Rán
ránar	Ránar
reimar	Reimar
reimari	Reimari
reimars	Reimars
reynir	Reynir
reyni	Reyni
reynis	Reynis
reyr	Reyr
reyrs	Reyrs
ritu	Ritu
rós	Rós
rósa	Rósa
rósar	Rósar
rún	Rún
rúnar	Rúnar
rútur	Rútur
saga	Saga
sögu	Sögu
skírnir	Skírnir
smári	Smári
smára	Smára
snær	Snær
snæ	Snæ
snæs	Snæs
sól	Sól
sólar	Sólar
sóley	Sóley
sóleyju	Sóleyju
sóleyjar	Sóleyjar
starri	Starri
starra	Starra
stefnir	Stefnir
stefni	Stefni
stefnis	Stefnis
stein	Stein
steini	Steini
steins	Steins
steinar	Steinar
steinn	Steinn
steingerðar	Steingerðar
steingerði	Steingerði
steingerður	Steingerður
stíg	Stíg
stígs	Stígs
stígur	Stígur
svala	Svala
svölu	Svölu
svanur	Svanur
svan	Svan
svani	Svani
svans	Svans
svein	Svein
sveini	Sveini
sveinn	Sveinn
sveins	Sveins
teit	Teit
teiti	Teiti
teits	Teits
tinna	Tinna
torfi	Torfi
torfa	Torfa
trausti	Trausti
trausta	Trausta
úlfar	Úlfar
úlfur	Úlfur
úlf	Úlf
úlfi	Úlfi
úlfs	Úlfs
una	Una
unu	Unu
unni	Unni
unnar	Unnar
vagn	Vagn
vagni	Vagni
vagns	Vagns
vaka	Vaka
vöku	Vöku
valur	Valur
val	Val
vali	Vali
vals	Vals
vala	Vala
völu	Völu
vanda	Vanda
vöndu	Vöndu
vera	Vera
veru	Veru
víðir	Víðir
víði	Víði
víðis	Víðis
víkingur	Víkingur
víking	Víking
víkingi	Víkingi
víkings	Víkings
vöggur	Vöggur
vörður	Vörður
vörð	Vörð
verði	Verði
varðar	Varðar
veigar	Veigar
vikar	Vikar
vikars	Vikars
ýr	Ýr
ýri	Ýri
ýrar	Ýrar
þór	Þór
þórs	Þórs
þorri	Þorri
þorra	Þorra
þráinn	Þráinn
þráin	Þráin
þráni	Þráni
þröstur	Þröstur
þröst	Þröst
þresti	Þresti
þrastar	Þrastar
