a.m.k	að minnsta kosti
e.t.v	ef til vill
m.a	meðal annars
t.d	til dæmis
t.a.m	til að mynda
o.s.frv	og svo framvegis
o.fl	og fleira
og fl	fleira
ofl	og fleira
s.s svo sem
sbr	samanber
þ.a.l	þar af leiðandi
þ.e	það er
þ.e.a.s	það er að segja
þ.m.t	þar með talið
sf	s f
sl	síðastliðin
s.l	síðastliðin
u.þ.b	um það bil
nk næstkomandi
n.k	næstkomandi
ehf	e h f
ohf	o h f
hf	h f
hrl	hæstaréttarlögmaður
th	t h
sr.	séra
dr.	doktor
próf.	prófessor
ferm.tölu	fermetratölu